
NO assets/no.xpm
SO assets/so.xpm     
WE assets/we.xpm
EA assets/ea.xpm


F 139, 121, 91
C 135, 206, 235


                11111111111111111
                10000001110000001
                10000000000000001
                11110000000001111
                10000000000000001
                10000000000000001
                11111110001111111
111111111111111110000000000000001
100000111110000000000000000000001
100000000000000000011100000000001
111111111111110001111111111111111
100000000000000000000000000000001
100000000000000N00000000000000001
101111111000000000000000000000001
100000000000000000000111110000001
111111111110000000000111110000001
100011110000000000000111110000001
100000000000000000011111111111111
10011111100000000001
10011001100110000001
10011000000000000001
11111111111111111111